Office Culture Enthusiast - ğŸ¢
Digital Explorer - ğŸŒ
Idea Maverick - ğŸ’¡
Rhythmic Maestro - ğŸ¶
Virtual Costume Artist - ğŸ­
Office Detective - ğŸ”
Virtual Cheerleader - ğŸ‰
Meeting Scheduler Extraordinaire - ğŸ—“ï¸
Office Puppet Master - ğŸ­
Grammar Guardian - ğŸ“
Microclimate Meteorologist - ğŸŒ¦ï¸
Pitch Prodigy - ğŸ›’
Virtual Fitness Guru - ğŸƒâ€â™‚ï¸
Whispering Wizard - ğŸ¤«
Virtual Camouflage Artist - ğŸ¦
Office Comedy Actor - ğŸ˜‚
Desk Puzzle Maestro - ğŸ§©
Avatar Transformation Artist - ğŸ¦„
Office Illusionist - âœ¨
Doodle Artisan - ğŸ¨
Virtual Fashionista Judge - ğŸ‘ 
Compliment Maestro - ğŸŒŸ
Desk Puppeteer Extraordinaire - ğŸ¤¹â€â™‚ï¸
Virtual Background Artisan - ğŸ–Œï¸
Inspiration Guru - ğŸŒŸ
Origami Maestro - âœ‚ï¸
Virtual Time Explorer - âŒ›
Narrative Magician - ğŸ“–
Green Sculptor - ğŸŒ¿
Cubicle Zen Master - â˜¯ï¸